崔希范





本条目没有列出任何参考或来源。（2007年7月） 
维基百科所有的内容都应该可供查证。请协助添加来自可靠来源的引用以改善这篇条目。无法查证的内容可能被提出异议而移除。 




道教





入门


基本教义


道 - 德 - 清静 - 无为
炁 - 阴阳 - 炼丹 - 仙 - 性命




道教人物


老子 - 关尹子 - 文子
列子 - 庄子 - 鬼谷子
张道陵 - 魏伯阳 - 许逊
魏华存 - 葛洪 - 寇谦之
陆修静 - 陶弘景 - 孙思邈
五祖七真 - 陈抟 - 王文卿
司马承祯 - 刘一明 - 邵元节
褚伯秀 - 陈景元 - 王重阳
丘处机 - 张三丰 - 陈撄宁




道教神仙


三清四御
元始天尊 - 灵宝天尊 - 道德天尊
玉皇大帝 - 后土娘娘 - 紫微 - 勾陈
南极长生大帝 - 太乙救苦天尊
先天尊神
西王母 - 东王公
斗姥元尊 - 三官大帝 - 五方五老
玄天上帝 - 雷声普化天尊
天地山川百神
九皇大帝 - 太阳星君 - 太阴星君
魁斗星君 - 嫦娥娘娘
东岳大帝 - 水仙尊王 - 四海龙王
金光圣母 - 雷公
冥府
酆都大帝 - 十殿阎君 - 五方鬼帝
黑白无常 - 阴阳司 - 判官 - 日夜游神
圣贤仙真
盘古 - 女娲 - 伏羲 - 神农 - 黄帝
八仙 - 纯阳祖师
九天玄女 - 骊山老母
百花仙子- 麻姑 - 三茅真君 - 黄大仙
护法神
托塔李天王 - 中坛元帅 - 二郎真君
驱魔真君锺馗 - 关圣帝君
温元帅 - 田都元帅 - 四大元帅
马天君 - 王灵官 - 五营神将
法主真君 - 辅天真君 - 弼天真君
民间俗神
天上圣母 - 泰山娘娘 - 灶君 - 福禄寿 - 财神 - 门神 - 城隍 - 境主 - 福德正神 - 月老 - 文昌帝君 - 天医真人 - 包公 -保生大帝 - 开漳圣王 - 广泽尊王 - 灵安尊王 - 三山国王 - 古公三王 - 九龙三公 -西秦王爷 - 洪圣大王 - 虎爷 - 七星娘娘 - 金花娘娘 - 临水夫人 - 注生娘娘 - 武夷真君 - 巧圣先师 - 岳武穆王 - 姜太公 - 张仙 - 清水祖师 - 董公祖师 - 五府千岁 - 五年千岁 - 五福王爷





道教宗派


黄老道- 方仙道 - 太平道 - 五斗米道
天师道 - 灵宝派 - 上清派
楼观道 - 茅山宗 - 阁皂宗 - 重玄派
天心派 - 东华派 - 神霄派 - 清微派
净明道 - 闾山派 - 太一道 - 真大道
全真道 - 金丹南宗 - 正一道 - 玄教
龙门派 - 天仙派 - 隐仙派




道教典籍


道德经 - 南华经 - 冲虚经 - 通玄经
阴符经 - 黄庭经 - 参同契 - 悟真篇
灵宝五符经 - 五岳真形图 - 三皇文
灵宝度人经 - 大洞真经 - 西昇经
清静经 - 心印经 - 功课经 - 感应篇
定观经 - 内观经 - 胎息经 - 文始经
北斗经 - 玉枢经 - 玉皇经 - 三官经
抱朴子 - 玄纲论 - 化书 - 云笈七签




洞天福地


玉京山 - 昆仑山 - 洞天
十洲三岛 - 十大洞天
三十六小洞天 - 七十二福地
道教名山




道教主题


历史 - 音乐 - 宫观 - 醮仪 - 道术








查
论
编





崔希范，唐朝人。号“至一真人”。撰《入药镜》论述道教内丹法。该书在内丹史上影响甚大。《修真十书·天元入药镜》有崔希范自述，题“唐庚子岁望日至一真人崔希范述”。
南宋曾慥《道枢》载，吕洞宾从崔希范受《入药镜》，并进而由此参悟内丹要妙。 《纯阳真人浑成集》卷下载吕洞宾诗云：“因看崔公《入药镜》，令人心地转分明。”《仙鉴》卷四十五条载吕岩“复于僖宗广明元年（ 880 年），遇崔公传《入药镜》，即知修行性命，不差毫发”。




分类：崔姓道家道教人物隐藏分类：自2007年7月缺少来源的条目唐朝人物小作品